30 30
15 15
18 19
0 0 0 0 0 0 0 0 0 0 0 0 0 0 0 0 0 0 0 0 0 0 0 0 0 0 0 0 0 0
0 0 0 0 0 0 0 0 0 0 0 0 0 0 0 0 0 0 0 0 0 0 0 0 0 0 0 0 0 0
0 0 5 5 4 4 3 2 1 0 0 0 0 0 9 9 0 0 0 0 0 1 2 3 4 4 5 5 0 0
0 0 5 3 3 3 2 1 0 0 0 0 0 0 9 9 0 0 0 0 0 0 1 2 3 3 3 5 0 0
0 0 4 3 2 2 1 0 0 0 0 0 0 0 8 8 0 0 0 0 0 0 0 1 2 2 3 4 0 0
0 0 4 3 2 2 1 0 0 0 0 0 0 0 7 7 0 0 0 0 0 0 0 1 2 2 3 4 0 0
0 0 3 2 1 1 0 0 0 0 0 0 0 0 6 6 0 0 0 0 0 0 0 0 1 1 2 3 0 0
0 0 2 1 0 0 0 0 0 0 0 0 0 0 5 5 0 0 0 0 0 0 0 0 0 0 1 2 0 0
0 0 1 0 0 0 0 0 0 0 0 0 0 0 4 4 0 0 0 0 0 0 0 0 0 0 0 1 0 0
0 0 0 0 0 0 0 0 0 0 0 0 0 0 3 3 0 0 0 0 0 0 0 0 0 0 0 0 0 0
0 0 0 0 0 0 0 0 0 0 1 1 1 1 2 2 1 1 1 1 0 0 0 0 0 0 0 0 0 0
0 0 0 0 0 0 0 0 0 0 1 1 1 2 2 2 2 1 1 1 0 0 0 0 0 0 0 0 0 0
0 0 0 0 0 0 0 0 0 0 1 1 2 2 2 2 2 2 1 1 0 0 0 0 0 0 0 0 0 0
0 0 0 0 0 0 0 0 0 0 1 2 2 2 2 2 2 2 2 1 0 0 0 0 0 0 0 0 0 0
0 0 9 9 8 7 6 5 4 3 2 2 2 2 2 2 2 2 2 2 3 4 5 6 7 8 9 9 0 0
0 0 9 9 8 7 6 5 4 3 2 2 2 2 2 2 2 2 2 2 3 4 5 6 7 8 9 9 0 0
0 0 0 0 0 0 0 0 0 0 1 2 2 2 2 2 2 2 2 1 0 0 0 0 0 0 0 0 0 0
0 0 0 0 0 0 0 0 0 0 1 1 2 2 2 2 2 2 1 1 0 0 0 0 0 0 0 0 0 0
0 0 0 0 0 0 0 0 0 0 1 1 1 2 2 2 2 1 1 1 0 0 0 0 0 0 0 0 0 0
0 0 0 0 0 0 0 0 0 0 1 1 1 1 2 2 1 1 1 1 0 0 0 0 0 0 0 0 0 0
0 0 0 0 0 0 0 0 0 0 0 0 0 0 3 3 0 0 0 0 0 0 0 0 0 0 0 0 0 0
0 0 1 0 0 0 0 0 0 0 0 0 0 0 4 4 0 0 0 0 0 0 0 0 0 0 0 1 0 0
0 0 2 1 0 0 0 0 0 0 0 0 0 0 5 5 0 0 0 0 0 0 0 0 0 0 1 2 0 0
0 0 3 2 1 1 0 0 0 0 0 0 0 0 6 6 0 0 0 0 0 0 0 0 1 1 2 3 0 0
0 0 4 3 2 2 1 0 0 0 0 0 0 0 7 7 0 0 0 0 0 0 0 1 2 2 3 4 0 0
0 0 4 3 2 2 1 0 0 0 0 0 0 0 8 8 0 0 0 0 0 0 0 1 2 2 3 4 0 0
0 0 5 3 3 3 2 1 0 0 0 0 0 0 9 9 0 0 0 0 0 0 1 2 3 3 3 5 0 0
0 0 5 5 4 4 3 2 1 0 0 0 0 0 9 9 0 0 0 0 0 1 2 3 4 4 5 5 0 0
0 0 0 0 0 0 0 0 0 0 0 0 0 0 0 0 0 0 0 0 0 0 0 0 0 0 0 0 0 0
0 0 0 0 0 0 0 0 0 0 0 0 0 0 0 0 0 0 0 0 0 0 0 0 0 0 0 0 0 0
