27 27
15 16
4 13
0 0 0 0 0 0 0 0 0 0 0 0 0 0 0 0 0 0 0 0 0 0 0 0 0 0 0
0 7 6 7 0 0 0 0 0 0 0 0 0 0 0 0 0 0 0 0 0 0 0 7 6 7 0
0 6 6 6 3 4 3 4 3 4 3 4 3 4 3 4 3 4 3 4 3 4 3 6 6 6 0
0 7 6 7 0 0 0 0 0 0 0 0 0 0 0 0 0 0 0 0 0 0 0 7 6 7 0
0 0 3 0 0 0 0 0 0 0 0 0 0 0 0 0 0 0 0 0 0 0 0 0 3 0 0
0 0 4 0 0 0 0 1 0 1 0 0 0 0 0 0 0 0 0 0 0 0 0 0 4 0 0
0 0 3 0 0 0 1 2 0 2 1 0 0 0 0 0 0 0 0 0 0 0 0 0 3 0 0
0 0 4 0 0 1 2 3 0 3 2 1 0 0 0 5 0 4 0 3 0 0 0 0 4 0 0
0 0 3 0 0 0 0 0 0 0 0 0 0 0 0 0 0 0 0 0 0 0 0 0 3 0 0
0 0 4 0 0 1 2 3 0 3 2 1 0 0 0 6 0 9 0 2 0 0 0 0 4 0 0
0 0 3 0 0 0 1 2 0 2 1 0 0 0 0 0 0 0 0 0 0 0 0 0 3 0 0
0 0 4 0 0 0 0 1 0 1 0 0 0 0 0 7 0 8 0 1 0 0 0 0 4 0 0
0 0 3 0 0 0 0 0 0 0 0 0 0 0 0 0 0 0 0 0 0 0 0 0 3 0 0
0 0 4 0 0 0 0 0 0 0 0 0 0 0 0 0 0 0 0 0 0 0 0 0 4 0 0
0 0 3 0 0 0 0 0 0 2 2 2 0 0 0 2 2 2 0 0 0 0 0 0 3 0 0
0 0 4 0 0 1 1 0 0 2 2 2 0 0 0 2 2 2 0 0 1 1 0 0 4 0 0
0 0 3 0 0 1 1 0 0 2 2 2 0 0 0 2 2 2 0 0 1 1 0 0 3 0 0
0 0 4 0 0 0 0 0 0 0 0 0 0 0 0 0 0 0 0 0 0 0 0 0 4 0 0
0 0 3 0 0 0 0 0 0 0 0 0 0 0 0 0 0 0 0 0 0 0 0 0 3 0 0
0 0 4 0 0 0 0 0 0 0 0 0 0 0 0 0 0 0 0 0 0 0 0 0 4 0 0
0 0 3 0 0 1 1 0 0 0 1 1 0 0 0 1 1 0 0 0 1 1 0 0 3 0 0
0 0 4 0 0 1 1 0 0 0 1 1 0 0 0 1 1 0 0 0 1 1 0 0 4 0 0
0 0 3 0 0 0 0 0 0 0 0 0 0 0 0 0 0 0 0 0 0 0 0 0 3 0 0
0 7 6 7 0 0 0 0 0 0 0 0 0 0 0 0 0 0 0 0 0 0 0 7 6 7 0
0 6 6 6 3 4 3 4 3 4 3 4 3 4 3 4 3 4 3 4 3 4 3 6 6 6 0
0 7 6 7 0 0 0 0 0 0 0 0 0 0 0 0 0 0 0 0 0 0 0 7 6 7 0
0 0 0 0 0 0 0 0 0 0 0 0 0 0 0 0 0 0 0 0 0 0 0 0 0 0 0
