38 20
4 14
5 4
0 0 0 0 0 0 0 0 0 0 0 0 0 0 0 0 0 0 0 0
0 0 0 0 0 0 0 0 0 0 0 0 0 0 0 0 0 0 0 0
0 0 2 2 2 2 2 2 2 2 2 2 2 2 0 0 2 2 0 0
0 0 2 2 2 2 2 2 2 2 2 2 2 2 0 0 2 2 0 0
0 0 2 2 0 0 0 0 0 0 0 0 0 0 0 0 3 3 0 0
0 0 2 2 0 0 0 0 0 0 0 0 0 0 0 0 3 3 0 0
0 0 2 2 4 4 2 4 4 0 4 4 4 4 0 0 4 4 0 0
0 0 2 2 4 4 2 4 4 0 4 4 4 4 0 0 4 4 0 0
0 0 2 2 0 0 2 2 0 0 1 1 0 2 0 0 2 2 0 0
0 0 2 2 0 0 0 2 2 0 1 1 0 2 0 0 2 2 0 0
0 0 2 2 4 4 0 0 2 2 0 0 2 0 0 0 2 2 0 0
0 0 2 2 4 4 2 0 0 2 2 2 0 0 0 2 2 2 0 0
0 0 2 2 2 2 2 2 0 0 0 0 0 0 3 3 2 2 0 0
0 0 2 2 4 4 2 2 0 0 0 0 0 0 3 3 2 2 0 0
0 0 2 2 4 4 2 0 0 2 2 0 0 0 0 0 2 2 0 0
0 0 2 2 2 2 0 0 2 2 2 2 0 0 0 0 2 2 0 0
0 0 2 2 4 4 0 0 4 4 2 2 2 2 4 4 2 2 0 0
0 0 2 2 4 4 0 0 4 4 2 2 2 2 4 4 2 2 0 0
0 0 2 2 0 0 0 0 0 0 0 0 0 0 0 0 2 2 0 0
0 0 2 2 0 0 0 0 0 0 0 0 0 0 0 0 2 2 0 0
0 0 2 2 0 0 2 2 4 4 0 0 4 4 4 4 2 2 0 0
0 0 2 2 0 0 2 2 4 4 0 0 4 4 4 4 2 2 0 0
0 0 2 2 0 0 2 2 0 0 0 0 0 0 0 0 2 2 0 0
0 0 2 2 1 1 2 2 0 0 0 0 0 0 0 0 2 2 0 0
0 0 2 2 2 2 2 2 2 2 2 2 2 2 4 4 2 2 0 0
0 0 2 2 2 2 2 2 2 2 2 2 2 2 4 4 2 2 0 0
0 0 1 2 2 1 1 1 1 2 2 1 2 2 2 2 2 2 0 0
0 0 1 2 2 1 0 0 1 2 1 0 1 2 2 2 2 2 0 0
0 0 1 2 2 1 0 0 1 2 2 1 2 2 3 2 2 2 0 0
0 0 1 2 2 1 1 1 1 2 2 2 2 3 3 3 2 3 0 0
0 0 1 2 2 2 2 2 2 2 1 1 2 2 3 2 2 4 0 0
0 0 1 2 2 1 1 1 2 1 0 0 1 2 2 2 3 5 0 0
0 0 1 2 2 1 0 1 2 1 0 0 1 2 2 3 4 6 0 0
0 0 1 2 2 1 1 1 2 2 1 1 2 2 3 4 5 7 0 0
0 0 1 2 2 2 2 2 2 2 2 2 2 3 4 5 6 8 0 0
0 0 1 2 2 2 2 2 1 1 2 3 4 5 6 7 8 9 0 0
0 0 0 0 0 0 0 0 0 0 0 0 0 0 0 0 0 0 0 0
0 0 0 0 0 0 0 0 0 0 0 0 0 0 0 0 0 0 0 0
