27 27
2 2
3 13
0 0 0 0 0 1 0 0 0 0 0 0 0 0 0 0 0 0 0 0 0 1 0 0 0 0 0
0 0 0 0 0 1 0 0 0 0 0 0 0 0 0 0 0 0 0 0 0 1 0 0 0 0 0
0 0 0 0 0 1 0 0 1 0 1 1 0 0 0 1 1 0 1 0 0 1 0 0 0 0 0
0 0 0 0 0 1 0 0 1 0 1 1 0 0 0 1 1 0 1 0 0 1 0 0 0 0 0
0 0 0 0 0 1 0 0 1 0 1 1 0 0 0 1 1 0 1 0 0 1 0 0 0 0 0
1 1 1 1 1 1 1 1 1 1 1 1 1 1 1 1 1 1 1 1 1 1 1 1 1 1 1
0 0 0 0 0 1 1 1 2 2 1 2 1 3 1 2 1 2 2 1 1 1 0 0 0 0 0
0 0 0 0 0 1 1 1 2 2 1 2 1 1 1 2 1 2 2 1 1 1 0 0 0 0 0
0 0 1 1 1 1 2 2 2 2 2 2 2 2 2 2 2 2 2 2 2 1 1 1 1 0 0
0 0 0 0 0 1 2 2 2 3 2 3 2 2 2 3 2 3 2 2 2 1 0 0 0 0 0
0 0 1 1 1 1 1 1 2 2 3 3 3 2 3 3 3 2 2 1 1 1 1 1 1 0 0
0 0 1 1 1 1 2 2 2 3 3 6 4 5 4 6 3 3 2 2 2 1 1 1 1 0 0
0 0 0 0 0 1 1 1 2 2 3 4 3 5 3 4 3 2 2 1 1 1 0 0 0 0 0
0 0 0 0 0 1 3 1 2 2 2 5 5 5 5 5 2 2 2 1 3 1 0 0 0 0 0
0 0 0 0 0 1 1 1 2 2 3 4 3 5 3 4 3 2 2 1 1 1 0 0 0 0 0
0 0 1 1 1 1 2 2 2 3 3 6 4 5 4 6 3 3 2 2 2 1 1 1 1 0 0
0 0 1 1 1 1 1 1 2 2 3 3 3 2 3 3 3 2 2 1 1 1 1 1 1 0 0
0 0 0 0 0 1 2 2 2 3 2 3 2 2 2 3 2 3 2 2 2 1 0 0 0 0 0
0 0 1 1 1 1 2 2 2 2 2 2 2 2 2 2 2 2 2 2 2 1 1 1 1 0 0
0 0 0 0 0 1 1 1 2 2 1 2 1 1 1 2 1 2 2 1 1 1 0 0 0 0 0
0 0 0 0 0 1 1 1 2 2 1 2 1 3 1 2 1 2 2 1 1 1 0 0 0 0 0
1 1 1 1 1 1 1 1 1 1 1 1 1 1 1 1 1 1 1 1 1 1 1 1 1 1 1
0 0 0 0 0 1 0 0 1 0 1 1 0 0 0 1 1 0 1 0 0 1 0 0 0 0 0
0 0 0 0 0 1 0 0 1 0 1 1 0 0 0 1 1 0 1 0 0 1 0 0 0 0 0
0 0 0 0 0 1 0 0 1 0 1 1 0 0 0 1 1 0 1 0 0 1 0 0 0 0 0
0 0 0 0 0 1 0 0 0 0 0 0 0 0 0 0 0 0 0 0 0 1 0 0 0 0 0
0 0 0 0 0 1 0 0 0 0 0 0 0 0 0 0 0 0 0 0 0 1 0 0 0 0 0
